10 1
1 10
7 6
XXXXXXXXXXXX
X..........X
X.XXXXXXX..X
X....X.....X
XXXX.X.XXXXX
X....X.....X
X.XXXX.X.XXX
X....X.X...X
XXX.XX..XX.X
X...X..X...X
X........XXX
XXXXXXXXXXXX
XXXXXXXXXXXX
X..........X
X..........X
X..........X
XXXXXXXXXXXX